NO ./textures/path_to_the_north_texture.xpm
SO ./textures/path_to_the_south_texture.xpm
WE ./textures/path_to_the_west_texture.xpm
EA ./textures/path_to_the_east_texture.xpm

C 0,200,200
F 225,30,0

11111111111111111111111111111111111111111111111111111111111111111111111111
10000000000000000000000000000000000000000000000000000000000000000000000001
10000000000000000000000000000000000000000000000000000000000000000000000001
10000000000000000000000000000000000000000000000000000000000000000000000001
10000011111000010101000000000000000000000000000000000000000000000000000001
10000010001000000000000000000000000000000000000000000000000000000000000001
10000010001000010001000000000000000000000000000000000000000000000000000001
10000010001000000000000000000000000000000000000000000000000000000000000001
10000011011000010101000000000000000000000000000000000000000000000000000001
10000000000000000000000000000000000000000000000000000000000000000000000001
10000000000000000000000000000000000000000000000000000000000000000000000001
10000000000000000000000000000000000000000000000000000000000000000000000001
1000000000000N000000000000000000000000000000000000000000000000000000000001
10000000000000000000000000000000000000000000000000000000000000000000000001
10000000000000000000000000000000000000000000000000000000000000000000000001
10000000000000000000000000000000000000000000000000000000000000000000000001
11111111100000000000000000000000000000000000000000000000000000000000000001
11010000100000000000000000000000000000000000000000000000000000000000000001
11000010100000000000000000000000000000000000000000000000000000000000000001
11010000100000000000000000000000000000000000000000000000000000000000000001
11011111100000000000000000000000000000000000000000000000000000000000000001
11000000000000000000000000000000000000000000000000000000000000000000000001
11111111100000000000000000000000000000000000000000000000000000000000000001
11111111111111111111111111111111111111111111111111111111111111111111111111
