NO ./textures/Sanrio_1.xpm
SO ./textures/Sanrio_2.xpm
WE ./textures/Sanrio_3.xpm
EA ./textures/Sanrio_4.xpm

C 255,230,230
F 255,160,160

        1111111111111111111111111
        1000000000100000000000001
        1011000001110001111111111
111111111000000000000001
111111111011000001110000111111111
100000000011000001110111111111
11110111111111011100000010001
11110111111111011101010010001
11000000110101011100000010001
10000000000000001100000010001
10000000000000001111111111111
1100000111000N01111
11110111 1110101 111111010001
11111111 1111111 111111111111
