NO ./textures/path_to_the_north_texture.xpm
SO ./textures/path_to_the_south_texture.xpm
WE ./textures/path_to_the_west_texture.xpm
EA ./textures/path_to_the_east_texture.xpm

F 100,150,0
C 100,150,150

11111111111111111111111111111111111111111111111111111111111111111111111111111111111111111111111111111111111111111111111111111111111111111111111111111111111111111111111111111111111111111111111111111111111111111
10000000000000000000000000000000000000000000000000000000000000000000000000000000000000000000000000000000000000000000000000000000000000000000000000000000000000000000000000000000000000000000000000000000000000111
1000000000000000000000000000000000000000000000000000000000000000000000000000000000000000000000000000000000000000000000000000000000000000000000000001111000000000000000000000000000000000000000000000000000011111
1000000000000001111111111111100000000000000000000000000000000000000000000000000000000000000000000000000000000011111000000000000000000000000000000000000000000000011110000000000000000011111111111111111111111
1000000000000000000000000000000000011000000000000000000000000000000000000000000000000000000000000000000000000011111000000000000000000000000000000000000000000000000000000000000000000000001111111111
10000000000000000000000000000000000000000000000000000000000000000000000000000000000000000000000000000000000000111110000000000000000000111100000000000000000000000000000000000000000001111111111
1000000000000000000000000000000000000000000000000000000000000000000000000000000000000000000000000000000000000011111000000000000000000000000000000000000000000000000000000000000000000111111111111
100000000000000000000000111100000000000000000000000000000000000000000000000000000000000000000000000000011111011111000000000000000000000000000000000000000000000001111111100000000000111111110001111111111
100000000000000000000000000000000000000000000000000000000000001111000000011110000000000000000000000000000000001111111111000000000011111111100000000000000000000000000000000000000000011111111000000000111111111
10000000000000000000000000000000000000000000000000000000111100000000000000000000000000011111111000000000000000111110000000000000100000011111111100000000000000000000000000000011111111111111100000000000000111111
1000000000000000000000000000000000000000000000000000000000000000000000000000000000000000000000000000000000000011111000000001111111110000000000000000000000111111111000000000000000011111111110000000111111111
100000000000000000000000001111000000000000111100000000000000000000000000111100000111100000001111111111110000001111100000000000000011111111100000000001111111110000000000000111111111011111111000000111
100001111000000000000000000000000000000000000000000000000011110000000001111000000000000000000000000000000000001111100000000000000011111111100000000000000000000000000000000000000000111111111000000001111
100000000111100000000000000000000000000000000000000000000000000011110000000000000000000000000000000000000000000000000001111111110000000000000000000000000000000000000011111000000000000000000000000000000111
1000000000000000000000000000000001111000000000000000000000000000000000001111111110000000000000000000000000000000000000000000000000000000000111111111000000000000000000000000000000000000000000000000011110111111
1000000000000000000000000000000000000000000000000000000000011110000000000000000000000000000000000011111111000000000000000000000111110000000000000000000000000000000000111000000000000000000000000001111111111
10000000000000000000000000000000000000000000000111100000000000001111000000000000000000000000000001111100000000000000000000000000000000000000000000011111111100000000001110000000000000000000001111111111
10000000000000000000000000000000000000000000000000000000000111100000000000000000000000011111111100000000001111111110000000000000000000000000000000000000000000000000001110011110000000000001111
10000000011111111000000000000000011111100000000000000000000000000000000000000000000000000000000000000000000000000000000000011111111100000000000000000000000000000000000000011100000000000000001111
100000000000000000000000000000011110000000000000111100000000000000000000000001111111100000000000000000011111111100000000000001111111110000000000000000000000000000000011111110000000001111001111111111111111
1000000000000000000000000000000000000000000000000000000000000000000000000001111111111110000000000000000000111111111000000000000001111100000000011111100111110000000000000000000000000011110000000000000011111
10000000000000000000000000000000000000000000000000000000000111100000000000000000000111100000000000011111111100000000000000000000011111000001111110000000000000000000000000000000000000111100000000000001111111111
10000000000000000011110000000001110000000000011110000000000000000000000000000000000000000000000000000000000000000001111111110000011111000001111110000000000000000000000011110000000000111100000000000000000000011
10000000000000000000000000000000011100000000000000000000000000001111111111111111110000000000000000000000000000000000000000000000001111100000011111100000000000000000000000000000000000011110000000000000000000001
10000000000000000000111100000000111100000000000000000000000000000000000011100000000000000000000000000111100000000000000000000000000000111111000000000011111111100000000000000111100000000000000000000111111111111
10000000000000000000000000000000000000000000000000000011111111111000001110000000000000000001111000000000111111111000000001100000000111100000000000000000000000000000000000111111111000000000000000000000000000001
1000000000000000000000000000000111100000000000000000001111111100011100000000W000000111110000000000000000000000000000000000000111100000000000000000000111111111000111100011110000000000000000000000000000000000111
10000000000000000000000000000000000000000000000000011111111111000000000000000000000000000000000000000000000000000000001111000000001111111110000000000000001111000000000000000000000000000000000000000000000000011
10000000000000000000000011110000000000000000000000001111111111000111100000111000000000011110000000000000000110000000001111111111000000000000000000000000001111001111111100000000001111000000000001111111110000011
1000000000000000000000000000000000000000000000000000001111110000111111111000000000000000000000000000000011111111100001111000000000000000110000000000000001111000000000000000000000000000000000000000000000000001
10000000000000000000000000000000000100000000011110000011111111000000000000000000110000000000000000000000000000000000001111000000000000000000000000000000001111000000000000000000000111111111000000000000000000001
10000011111111000000000000000000000000000000000000000000000000000000000000000011110000000011110000001111000001111101111000001111111111111111110000001111000000000011111111100000000000000000000000000000000000001
10000000000000111111110000000000000000000000000000000000000000000000000000000000000000000011110111100000000001111100000000000000111111111000000000000000000100000000000000000000000000000000000000001111111110001
10000000111111110000000000000000000000000001110000100000000000000000000000000111111111000011110000000000000001111111100000000000000000000001000000011111111110000000000000000000000111100000000000000000000000001
10000000000000011111111000000000000000000000000000000000000000000000000000111111111000000011110000000000000001111100000000000000000000000000000000000000000000000000000000000000000000000000000000000001111111111
10000000000001111111100000000000000111111111111100100000000000000000000111111111000000000011111111111101111001111100000000000000000001111000000000000000000000000000000000000111111111111000000001111000000000001
10000000000000000011110000000000000000010100001000000000000000000000000000000001111000000000000000011111111100000000000001111111110000000000000000000011111000000000000000001111000000000000000000000000000000001
10000000000000000000000000011110000000000000000000000000000000000000000000111100000000000000000001111111110000000000100000000000011111000000000000000000000000000000000000000000000000000000000000011110000000001
10000000000000000000000000000000000000000000000000000000000000000000000000000000000000000000000000000000000000000111000001111111110000011111010000000000011110000000000000000000000000000000000000000000000000001
10000000000000000111100000000000000000000000000000000000000000000000000000000000000000000111110000000000000000000111000000000000000000111110000000000000000000000000000000000001111111110000000000000000000000001
10000000000000000000000000000000000000111111110000111100000000000000000000000000000001111000000000000011110000000111000000000000000001111111110000000000000000000000111110000000011011110000000000000000000000001
10000000000000000000000000000111111110000000000000000000000000000000000000000000000000000000000000000000000000000111000000000000000011110000000001111100000000000000000000000000011000000000000000011111111100001
10000111100000000000000000000000000000111111110000000000000000000111111110011110000000001110000000000000001110000000000000000000000001110001111000000000000000000000000000000000000110000000000000000000000000001
10000000000000000000000000000000000000000000000000000000000000000000000000000000000000001110011000000000001110110001111111110000000000011110000000000000111000000000011110000000000111111111000000000000000000001
10000000000000000000001111000000000111100000000000000000000111100000001111000000000000001110000000000000001110000000000000001111000000000000000000000000000000000111100000000000000000000000000000000000000000111
10000000000111100000000111100000000000000000000000000000000000000000000000000000000000001110000000000000001110000000111111111011111111100000000000000000000000000000000111100001111111100000000000000000000011111
10000000000000000000000000000000011111110000000000000000000000000000011110000111100000001110111111111000000000000000000000000000000000000000000000000000000000000000000111111111111111100000000000000000000000001
10000000000000000000000000000000011111110000000000000000000000000000000000000000000000000000000000000000000111000000000000000011110000000000000111100000000000000011110111111110000001111000000000000000000000001
11111111111111111111111111111111111111111111111111111111111111111111111111111111111111111111111111111111111111111111111111111111111111111111111111111111111111111111111111111111111111111111111111111111111111111
