NO ./textures/path_to_the_north_texture.xpm
SO ./textures/path_to_the_south_texture.xpm
WE ./textures/path_to_the_west_texture.xpm
EA ./textures/path_to_the_east_texture.xpm

F 220,100,0
C 225,30,0

1111111111111111111111111111111111111111111111
1000000000000000000000000000000000000000000001
1000000000000000000000000000000000000000000001
1000000000000001111111111111100000000000000001
1000000000000000000000000000000000011000000001
1000000000000000000000000000000001000000000001
10000000000000000000000000000111110N0000000001
1000000000000000000000000000000000010000000001
1000000000000000000000000000000000000000000001
1000000000000000000000000000000000000000000001
1000000000000000000000000000000000011100001001
1000000000000000000000000000000000000000000001
1000000000000000000000000000000000010100001001
1000000000000000000000000001111111111111001001
1000000000000000000000000000000000000000000001
1111111111111111111111111111111111111111111111




