SO ./textures/Sanrio_1.xpm
NO ./textures/Sanrio_2.xpm
EA ./textures/Sanrio_3.xpm
WE ./textures/Sanrio_4.xpm

C 255,230,230
F 255,160,160

        11111111111111111111111111111111
        10000000001000000000000000000001
        10110000011100011111000000000001
1111111110000000000000000000000000111111
1111111110110000011100001111000000011111
1000000000110000011101111000010000001
111101111111110111000000000000001111
11111111000111010100100000000001
1      100000011010100N00011000011111111
111    10100000001100110000011000000111
1011111100000000011111111000000001001
110000011100000010000000000011110001
11110111 1110101 1111110000000000001
11111111 1111111 1111111111111111111
