NO ./textures/path_to_the_north_texture.xpm
SO ./textures/path_to_the_south_texture.xpm
WE ./textures/path_to_the_west_texture.xpm
EA ./textures/path_to_the_east_texture.xpm

F 220,100,0
C 225,30,0

        1111111111111111111111111
        1000000000100000000000001
        1011000001110001111111111
111111111000000000000001
111111111011000001110011111111111
100000000011000001110111111111
11110111111111011100000010001
11110111111100011101010010001
110000001100S1011100000010001
10000000000010001100000011
10000000000000001101010011111
1100000111010101111101111010111
11110111 1110101 101111010001
11111111 1111111 111111111111

